........................................#########......
........................................#.......#......
........................................#.......#......
........................................#.......#......
........................................#.......#......
........................................#.......#......
....................................#############......
....................................#...#..............
....................................#...#..............
....................................#...#..............
....................................#...#########......
....................................#...........#......
..............................#########.........#......
..............................#.....#.#.........#......
............#############.....#.....######^.....#......
............#.................#.......#.........#......
..#######...#.............###########.#.........#......
..#.....#...#.............#...#.....#.#.........#......
#######.#...#.............#...#.....#.#.........#......
#.#...#.#...#.............#...#.....#.#.........#......
#.#...#.#...#.............#...#.....#.#.........#......
#.#...#.#...#.............#...#.....#.#.........#......
#.###########.............#...#######.#.........#######
#.....#.#.................#...........#...............#
#.....#.#.....#############...........#########.......#
#.....#.#.....#...............................#.......#
#########.....#...............................#.......#
......#.......#...............................#.......#
......#.......#.........................###########...#
......#.......#.........................#.....#...#...#
......#########.........................#.#############
........................................#.#...#...#....
........................................#.#...#...#....
........................................#.#...#...#....
........................................#######...#....
..........................................#.......#....
..........................................#########....
